NO textures/Wall1.xpm
SO textures/Wall2.xpm
EA textures/Wall3.xpm
WE textures/Wall4.xpm

F 194,178,128
C 112,195,208

        1111111111111111111111111
        1000000000110000000000001
        101100000111000000W000001
        1001000000000000000000001
111111111011000001110000000000001
100000000011000001110111111111111
11110111111111011100000010001
1111011  11111011101010010001
11000011110101011100000010001
10000000000000001100000010001
10000000000000001101010010001
1100000111010101111101111000111
11110111 1110101 101111010001
11111111 1111111 111111111111
