NO textures/Wall1.xpm
SO textures/Wall2.xpm
EA textures/Wall3.xpm
WE textures/Wall4.xpm

F 194,178,128
C 112,195,208

111111111111111111111111
100000000000001010000001
100000000000000000000001
100000000000001N10000001
111111111111111111111111
