NO textures/Wall1.xpm
SO textures/Wall3.xpm
EA textures/Wall2.xpm
WE textures/Wall4.xpm

F 194,178,128
C 112,195,208

111111111111
100000000001
111112111111
100000001001
100000002001
10000N001001
111111111111
