NO textures/Wall1.xpm
SO textures/Wall3.xpm
EA textures/Wall2.xpm
WE textures/Wall4.xpm

F 194,178,128
C 112,195,208

111111111111111111111111111111
111100000001111111100000001111
111000000000111111000000000111
110000BBB000011110000BBB000011
1B0000BAB0000B11B0000BAB0000B1
110000C0C000011110000C0C000011
111000000000111111000000000111
111100000001111111100000001111
111111121111111111111121111111
11000BA00000B0000B000000AB0001
100CB000000000000000000000BC01
11000B0000000000000000000B0001
111111111111100001111111111111
1111111111111A00A1111111111111
1111000001B00000000B1000001111
11100B0001C00000000C1000B00111
11000C00020000000000200C000011
1100BC00020000000000200C0B0011
111000000100000000001000000111
1111000001B0000N000B1000001111
111111111111111111111111111111
