NO textures/Wall1.xpm
SO textures/Wall3.xpm
EA textures/Wall2.xpm
WE textures/Wall4.xpm

F 194,178,128
C 112,195,208

111111111111
100000000001
111112111111
100000000001
100000000001
10000N000001
111111111111
