NO textures/Wall1.xpm
SO textures/Wall3.xpm
EA textures/Wall2.xpm
WE textures/Wall4.xpm

F 194,178,128
C 112,195,208

111111111111111111111111111111111111111111111111111111111
110S011                                   11B0A0AB11
1100011111111111111       11111111111111111B00000CB1
1B000B10000200CBB01       11B00000000000002000000C01
1B000B10000100CBB01       1BBC0000001111111B00000CB1
1112111112111111111       11000000001     11B0A0AB11
11000B11B001110A0B11111111112111B0B01     1111111111
100C00200A0020000020B00C111A0B1100001
11B00B110B01110A0B1000000200000200001
11111111111111111111C0B011B000A110011
                  1111111111111111111
