NO textures/Wall1.xpm
SO textures/Wall3.xpm
EA textures/Wall2.xpm
WE textures/Wall4.xpm

F 194,178,128
C 112,195,208

111111111111111111111
100000000000000000001
100000000B00000000001
1000B0A00000000000001
10000000000000B000001
1000000000000A0000001
10000A000N00000000001
100000000000000000001
111111111111111111111
